12 50
**************************************************
*     *            *       ****         *        *
** ** ***** ** *****                 *           *
*  *         * *   *                 *  *  *     *
*  *    *    * * * *                 ********    *
*       *        * *                        *    *
*************  **  *                      ***    *
*                  *                     *       *
*                                        *       *
******************************************** *****
*                                                *
************************************************ *
